+#+#+#+#+#+#+
#           #
+ + + + +#+ +
#       #   X
+ + + + + + +
#   #   #E# #
+ + +#+#+ + +
#           #
+ + +#+ + + +
#   #   # # #
+ + +#+ +#+ +
#  M        #
+#+#+#+#+#+#+
