+#+#+#+#+#+#+
#           #
+ + +#+ + + +
#E    #     #
+ + + + +#+ +
X #     #   #
+ + + + + + +
#           #
+ +#+ + + +#+
#   #     # #
+ + + + + + +
#  M        #
+#+#+#+#+#+#+